a	A
b	B
c	C
d	D
e	E
f	F
g	G
h	H
i	I
j	J
k	K
l	L
m	M
n	N
o	O
p	P
q	Q
r	R
s	S
t	T
u	U
v	V
w	W
x	X
y	Y
z	Z
à	À
â	Â
ä	Ä
ô	Ô
ö	Ö
ê	Ê
é	É
è	È
ë	Ë
û	Û
ù	Ù
ü	Ü
î	Î
ï	Ï
ç	Ç